111111111111111111111111111111111111111111
1EC00010100000111111CCC0000000000000000001
10000000000000000000000000000000P000000011
10000000011100CCCC100000001110000000001111
111111111111111111111100000000000000111111
11111111111111111110000000000000CCC1111111
11111111111111111110000000000000C111111111
11111111111111111111111111111000CCC0000011
11111111111CCCCCCCCC0000000000011111111111
111111100000000000000CCCCCCC11111111111111
111111111111111111111111111111111111111111
