111111111111111111
11100000P0000C0001
101000CC00000E1111
100001011011000111
111111111111111111