1111111111111111111111
1000000011110000000001
1000000100001100000111
110C000CCCPCC111111111
1000011C0CCCCCC0000001
100000ECCCCCC101111001
1000100010001010100101
1111111111111111111111
