111111111111111111
11100000P000000001
101000CC0000E01111
100000011011111111
111111111111111111